-1 -1 -1 36 -1 -1 -1 -1 -1 -1 -1 -1 -1 -1 36 -1 -1 37 -1 -1 -1 -1 -1 -1 -1 -1 38 -1 -1 37 -1 -1 -1 38 -1 -1 -1 -1 -1 -1
-1 -1 -1 54 -1 -1 -1 -1 -1 -1 -1 -1 -1 -1 54 -1 -1 -1 -1 -1 -1 -1 -1 -1 -1 -1 56 -1 -1 -1 -1 -1 -1 56 -1 -1 -1 -1 -1 -1
-1 -1 -1 -1 -1 -1 -1 -1 -1 -1 -1 -1 -1 -1 -1 -1 -1 -1 -1 -1 -1 -1 -1 -1 -1 -1 74 -1 -1 -1 -1 -1 -1 74 -1 -1 -1 -1 -1 -1
-1 -1 -1 -1 -1 -1 -1 -1 -1 -1 -1 -1 -1 -1 -1 -1 -1 -1 -1 -1 -1 -1 -1 -1 -1 -1 -1 77 78 79 80 81 -1 -1 -1 -1 -1 -1 -1 -1
-1 -1 -1 -1 -1 -1 -1 -1 -1 -1 -1 -1 -1 -1 -1 -1 -1 -1 -1 -1 -1 -1 -1 -1 -1 -1 -1 -1 -1 -1 -1 -1 -1 -1 -1 -1 -1 -1 -1 -1
-1 -1 -1 -1 -1 -1 -1 -1 -1 -1 -1 -1 -1 -1 -1 -1 -1 -1 -1 -1 -1 -1 -1 -1 -1 -1 -1 -1 -1 -1 -1 -1 -1 -1 -1 -1 90 91 92 93
-1 -1 -1 -1 -1 -1 -1 -1 -1 -1 -1 -1 -1 -1 -1 -1 -1 -1 -1 -1 -1 -1 -1 -1 -1 -1 -1 -1 -1 -1 -1 -1 -1 -1 -1 -1 108 109 110 111
-1 -1 77 78 79 80 81 -1 -1 -1 -1 -1 -1 -1 -1 -1 -1 -1 -1 -1 -1 11 12 13 14 15 16 17 -1 -1 -1 -1 -1 -1 -1 -1 126 127 128 129
-1 -1 -1 -1 -1 -1 -1 -1 -1 -1 -1 -1 -1 -1 -1 -1 -1 -1 -1 -1 -1 29 30 31 32 33 34 35 -1 -1 -1 -1 -1 -1 -1 -1 144 145 146 147
-1 -1 -1 -1 -1 -1 -1 -1 -1 -1 -1 -1 -1 -1 -1 -1 -1 -1 -1 -1 -1 47 48 49 50 51 52 53 -1 -1 77 78 79 80 81 77 78 79 80 81
-1 -1 -1 -1 -1 -1 -1 -1 -1 -1 -1 -1 -1 -1 -1 -1 -1 -1 -1 -1 -1 65 66 67 68 69 70 71 -1 -1 -1 -1 -1 -1 -1 -1 -1 -1 -1 -1
-1 -1 -1 -1 -1 -1 -1 -1 -1 -1 -1 -1 -1 -1 -1 -1 -1 -1 -1 -1 -1 83 84 85 86 87 88 89 -1 -1 -1 -1 -1 -1 -1 -1 -1 -1 -1 -1
-1 -1 -1 -1 -1 -1 -1 -1 -1 -1 -1 -1 -1 -1 -1 -1 -1 -1 -1 -1 -1 101 102 103 104 105 106 107 -1 -1 -1 -1 -1 -1 -1 -1 -1 -1 -1 -1
-1 -1 -1 -1 -1 -1 -1 -1 -1 -1 -1 -1 -1 -1 -1 -1 -1 -1 -1 -1 -1 119 120 121 122 123 124 125 -1 -1 -1 -1 -1 -1 -1 -1 -1 -1 -1 -1
130 131 132 133 134 -1 97 98 99 -1 -1 -1 -1 -1 -1 -1 -1 -1 -1 97 98 99 138 139 140 141 142 143 -1 -1 57 58 130 131 132 133 134 -1 57 58
148 149 150 151 152 147 115 116 117 147 147 147 147 147 147 147 147 147 147 115 116 117 156 157 158 159 160 161 147 148 75 76 148 149 150 151 152 -1 75 76
171 171 171 171 171 171 171 171 171 171 171 171 171 171 171 171 171 171 171 171 171 171 171 171 171 171 171 171 171 171 171 171 171 171 171 171 171 171 171 171
162 162 162 162 162 162 162 162 162 162 162 162 162 162 162 162 162 162 162 162 162 162 162 162 162 162 162 162 162 162 162 162 162 162 162 162 162 162 162 162
162 162 162 162 162 162 162 162 162 162 162 162 162 162 162 162 162 162 162 162 185 185 185 162 162 162 162 162 162 162 162 162 162 187 187 187 187 187 162 162
185 185 162 162 162 162 162 162 162 162 162 162 162 162 162 162 162 162 162 162 185 185 185 162 162 162 162 162 162 162 162 162 162 187 187 187 187 187 162 162
185 185 162 162 162 162 162 162 162 162 182 182 182 182 182 162 162 162 162 162 188 188 162 162 162 162 162 162 162 162 162 162 162 187 187 187 187 187 162 162
162 162 162 162 162 162 162 162 162 162 182 182 182 182 182 162 162 162 162 162 162 162 162 162 162 162 162 162 162 162 162 162 162 162 162 162 162 162 162 162
185 185 162 162 162 162 162 162 162 162 182 182 182 182 182 162 162 162 162 162 188 188 162 162 162 162 162 162 162 162 162 162 162 187 187 187 187 187 162 162
162 162 162 162 162 162 162 162 162 162 182 182 182 182 182 162 162 162 162 162 162 162 162 162 162 162 162 162 162 162 162 162 162 162 162 162 162 162 162 162
