-1 -1 -1 -1 -1 -1 -1 -1 -1 -1 -1 -1 -1 -1 -1 -1 -1 -1 -1 -1 -1 -1 -1 -1 -1 -1 -1 -1 -1 -1 -1 -1 -1 -1 -1 -1 -1 -1 -1 -1
-1 -1 -1 -1 -1 -1 -1 -1 -1 -1 -1 -1 -1 -1 -1 -1 -1 -1 -1 -1 -1 -1 -1 -1 -1 -1 -1 -1 -1 -1 -1 -1 -1 -1 -1 -1 -1 -1 -1 -1
-1 -1 -1 -1 -1 -1 -1 -1 -1 -1 -1 -1 -1 -1 -1 -1 -1 -1 -1 -1 -1 -1 -1 -1 -1 -1 -1 -1 -1 -1 -1 -1 -1 -1 -1 -1 -1 -1 -1 -1
-1 -1 -1 -1 -1 -1 -1 -1 -1 -1 -1 -1 -1 -1 -1 -1 -1 184 80 79 79 79 -1 -1 -1 -1 -1 -1 -1 -1 -1 -1 -1 -1 -1 -1 -1 -1 -1 -1
-1 -1 -1 -1 -1 -1 -1 -1 -1 -1 -1 -1 -1 -1 -1 -1 -1 -1 -1 -1 -1 -1 -1 -1 -1 -1 -1 -1 -1 -1 -1 -1 -1 -1 -1 -1 -1 -1 -1 -1
-1 -1 -1 -1 -1 -1 -1 -1 -1 -1 -1 184 80 81 -1 -1 -1 -1 -1 -1 -1 -1 -1 -1 -1 -1 -1 78 79 79 79 80 -1 -1 -1 -1 -1 -1 -1 -1
-1 -1 -1 77 78 79 79 79 79 80 81 182 -1 -1 -1 -1 -1 -1 -1 -1 -1 -1 -1 -1 -1 -1 -1 184 -1 -1 -1 184 -1 -1 -1 -1 -1 -1 -1 -1
-1 -1 -1 -1 -1 -1 -1 -1 -1 -1 -1 182 -1 -1 -1 -1 -1 -1 -1 -1 -1 -1 -1 -1 -1 -1 -1 183 -1 -1 -1 183 -1 -1 -1 -1 -1 -1 -1 -1
-1 -1 -1 -1 -1 -1 -1 -1 -1 -1 -1 -1 -1 79 77 78 -1 -1 -1 -1 -1 -1 -1 -1 79 77 78 183 -1 -1 -1 183 80 81 -1 -1 -1 -1 -1 -1
-1 -1 -1 -1 -1 -1 -1 -1 -1 -1 -1 -1 -1 -1 -1 -1 -1 -1 -1 -1 -1 -1 -1 -1 -1 -1 -1 -1 -1 -1 -1 -1 -1 -1 -1 -1 -1 -1 -1 -1
-1 -1 -1 -1 -1 -1 -1 -1 -1 -1 -1 -1 -1 -1 -1 -1 -1 79 79 79 -1 -1 -1 -1 -1 -1 -1 -1 -1 -1 -1 -1 -1 -1 79 79 79 79 -1 -1
-1 -1 -1 -1 -1 -1 -1 -1 -1 -1 -1 -1 -1 -1 -1 -1 -1 -1 -1 184 -1 -1 -1 -1 -1 -1 -1 -1 -1 -1 -1 -1 -1 -1 -1 -1 -1 -1 -1 -1
-1 -1 -1 -1 -1 -1 -1 -1 -1 -1 -1 -1 -1 -1 -1 -1 -1 -1 -1 183 79 79 79 79 -1 -1 -1 -1 -1 -1 -1 -1 -1 -1 -1 -1 -1 -1 -1 96
-1 -1 -1 -1 -1 -1 -1 -1 -1 -1 -1 -1 -1 -1 -1 -1 -1 -1 -1 -1 -1 -1 -1 -1 -1 -1 -1 -1 -1 -1 -1 -1 -1 -1 -1 -1 -1 -1 77 78
184 184 184 184 184 -1 -1 -1 -1 -1 -1 -1 -1 -1 -1 -1 -1 -1 -1 -1 -1 -1 -1 -1 -1 -1 -1 -1 -1 -1 -1 -1 -1 -1 -1 -1 -1 -1 -1 -1
181 181 180 183 181 184 184 184 184 184 184 184 184 184 184 184 184 184 184 184 184 184 184 184 184 184 184 184 184 184 184 184 184 184 184 184 184 184 184 184
180 182 180 183 183 180 183 180 181 181 183 181 183 183 180 180 182 183 183 182 181 180 182 183 181 180 180 183 181 182 180 180 180 183 181 183 183 181 181 181
183 182 180 180 180 183 183 180 183 182 180 183 182 183 183 182 183 180 181 180 182 180 182 181 180 180 182 182 182 182 183 181 182 182 183 182 182 182 183 183
181 182 183 180 183 182 182 182 181 183 181 182 181 181 183 182 182 180 181 181 182 182 181 183 180 181 180 180 181 183 181 183 182 181 180 180 180 180 183 183
181 180 182 181 181 183 180 181 181 183 181 182 182 180 182 181 183 181 183 181 181 182 182 183 182 182 183 181 183 180 182 182 183 180 182 181 180 182 180 182
181 180 181 180 180 180 -1 -1 -1 -1 -1 182 182 183 180 182 182 182 -1 -1 -1 -1 -1 180 180 180 183 183 180 181 -1 -1 -1 -1 -1 180 181 180 183 181
182 183 181 182 181 183 -1 -1 -1 -1 -1 180 183 182 180 182 180 182 -1 -1 -1 -1 -1 180 180 182 181 183 181 181 -1 -1 -1 -1 -1 183 183 181 182 180
181 180 181 180 180 180 -1 -1 -1 -1 -1 182 182 183 180 182 182 182 -1 -1 -1 -1 -1 180 180 180 183 183 180 181 -1 -1 -1 -1 -1 180 181 180 183 181
