170 185 188 169 167 168 163 168 186 185 187 188 186 188 170 170 170 162 165 188 113 73 114 114 112 112 -1 -1 -1 -1 -1 -1 -1 -1 -1 -1 -1 -1 -1 -1
170 186 170 167 165 165 163 185 186 165 163 164 186 185 187 185 186 186 188 165 166 166 166 166 166 166 -1 -1 -1 -1 -1 -1 -1 -1 -1 -1 -1 -1 -1 -1
165 186 170 187 186 162 165 163 164 169 165 164 164 165 165 163 188 188 188 165 163 162 168 165 165 163 -1 -1 -1 -1 -1 -1 -1 -1 -1 -1 -1 -1 -1 -1
169 170 170 186 164 163 163 38 -1 36 -1 -1 163 163 163 165 164 163 164 164 187 187 187 165 162 162 166 -1 -1 -1 -1 -1 -1 -1 -1 -1 -1 -1 -1 -1
170 188 188 162 55 -1 -1 56 -1 54 -1 -1 55 -1 -1 38 55 -1 -1 37 169 187 187 186 165 164 164 166 72 -1 -1 -1 -1 -1 -1 -1 -1 -1 -1 -1
170 187 163 162 -1 -1 -1 74 -1 -1 -1 -1 -1 -1 -1 56 -1 -1 -1 -1 -1 -1 38 165 162 167 164 163 166 166 113 114 -1 57 58 -1 -1 -1 -1 -1
188 187 164 -1 -1 -1 -1 -1 -1 -1 -1 -1 -1 -1 -1 74 -1 -1 -1 -1 -1 -1 56 -1 37 163 164 165 165 162 166 166 112 75 76 -1 97 98 99 -1
187 188 165 -1 -1 -1 -1 -1 -1 -1 -1 -1 -1 -1 -1 -1 -1 -1 -1 -1 -1 -1 74 -1 -1 -1 163 163 162 162 164 165 166 166 166 114 115 116 117 -1
170 185 164 -1 -1 -1 -1 -1 -1 -1 -1 -1 -1 -1 -1 -1 -1 -1 -1 -1 -1 -1 -1 -1 -1 -1 55 -1 162 168 165 163 165 163 164 166 166 166 166 112
170 186 165 -1 -1 -1 -1 -1 -1 -1 -1 -1 -1 -1 -1 -1 -1 -1 -1 -1 -1 -1 -1 -1 -1 -1 -1 -1 36 -1 168 167 170 169 165 163 165 164 170 166
188 188 187 -1 -1 -1 -1 -1 -1 -1 -1 -1 -1 -1 -1 -1 -1 -1 -1 -1 -1 -1 -1 -1 -1 -1 -1 -1 54 -1 -1 -1 -1 187 185 188 187 168 163 162
188 170 187 167 153 -1 -1 -1 -1 -1 -1 -1 -1 -1 -1 -1 -1 -1 -1 -1 -1 -1 -1 -1 -1 -1 -1 -1 -1 -1 -1 -1 -1 38 -1 -1 -1 167 162 186
170 186 164 164 168 163 169 -1 135 -1 135 -1 -1 -1 -1 -1 -1 -1 -1 -1 -1 -1 -1 -1 -1 -1 -1 -1 -1 -1 -1 -1 -1 56 -1 -1 -1 -1 -1 -1
170 188 170 185 185 188 186 167 170 186 162 165 167 165 165 -1 -1 -1 -1 -1 -1 -1 -1 -1 -1 -1 -1 -1 -1 -1 -1 -1 -1 74 -1 -1 -1 -1 -1 -1
185 164 185 -1 -1 37 37 -1 167 167 187 165 164 165 165 164 -1 -1 -1 -1 -1 -1 -1 -1 -1 -1 -1 -1 -1 -1 -1 -1 -1 -1 -1 -1 -1 -1 -1 -1
188 162 -1 -1 -1 -1 -1 -1 -1 37 -1 -1 163 163 187 162 164 -1 -1 -1 -1 -1 -1 -1 -1 -1 -1 -1 -1 -1 -1 -1 -1 -1 -1 -1 -1 -1 -1 -1
187 170 -1 -1 -1 -1 -1 -1 -1 -1 -1 -1 -1 55 55 167 164 163 -1 -1 -1 -1 -1 -1 -1 -1 -1 -1 -1 -1 -1 -1 -1 -1 -1 -1 -1 -1 -1 -1
187 168 162 -1 -1 -1 -1 -1 -1 -1 -1 -1 -1 -1 -1 -1 168 165 186 -1 -1 -1 -1 -1 -1 -1 -1 -1 -1 -1 -1 -1 -1 -1 -1 -1 -1 -1 -1 -1
185 185 162 164 -1 -1 -1 -1 -1 -1 -1 -1 -1 -1 -1 -1 -1 162 165 153 -1 -1 -1 -1 -1 -1 -1 -1 -1 -1 -1 -1 -1 -1 -1 -1 -1 -1 -1 -1
170 188 169 164 163 -1 -1 -1 -1 -1 -1 -1 -1 -1 -1 -1 -1 -1 162 167 165 -1 -1 -1 -1 -1 -1 -1 -1 -1 -1 -1 -1 -1 -1 113 114 114 113 114
188 170 188 187 188 186 165 135 -1 135 155 155 154 155 154 153 -1 -1 -1 -1 -1 -1 -1 -1 -1 -1 -1 -1 -1 166 166 166 166 166 166 166 166 166 166 166
186 188 170 185 188 187 188 165 162 164 164 162 164 164 163 164 164 164 163 162 163 162 164 163 165 162 164 162 164 162 165 163 163 188 187 170 170 188 188 188
186 188 170 185 188 187 188 165 162 164 164 162 164 164 163 164 164 164 163 162 163 162 164 163 165 162 164 162 164 162 165 163 163 188 187 170 170 188 188 188
