-1 -1 -1 -1 -1 -1 -1 -1 -1 -1 -1 -1 -1 -1 -1 -1 -1 -1 -1 -1 -1 -1 -1 -1 -1 -1 -1 -1 -1 -1 -1 -1 -1 -1 -1 -1 -1 -1 -1 -1
-1 -1 -1 -1 -1 -1 -1 -1 -1 -1 -1 -1 -1 -1 -1 -1 -1 -1 -1 -1 -1 -1 -1 -1 -1 -1 -1 -1 -1 -1 -1 -1 -1 -1 -1 -1 -1 -1 -1 -1
-1 -1 -1 -1 -1 -1 -1 -1 -1 -1 -1 -1 -1 -1 -1 -1 -1 -1 -1 -1 -1 -1 -1 -1 -1 -1 -1 -1 -1 -1 -1 -1 -1 -1 -1 -1 -1 -1 -1 -1
-1 -1 -1 -1 -1 -1 -1 -1 -1 -1 -1 -1 -1 -1 -1 -1 -1 -1 -1 -1 -1 -1 -1 -1 -1 -1 -1 -1 -1 -1 -1 -1 -1 -1 -1 -1 -1 -1 -1 -1
-1 -1 -1 -1 -1 -1 -1 -1 -1 -1 -1 -1 -1 -1 -1 -1 -1 -1 -1 -1 -1 -1 -1 -1 -1 -1 -1 -1 -1 -1 -1 -1 -1 -1 -1 -1 -1 -1 -1 -1
-1 -1 -1 -1 -1 -1 -1 -1 -1 -1 -1 -1 -1 -1 -1 -1 -1 -1 -1 -1 -1 -1 -1 -1 -1 -1 -1 -1 -1 -1 -1 -1 -1 -1 -1 -1 -1 -1 -1 -1
-1 -1 -1 -1 -1 -1 -1 -1 -1 -1 -1 -1 -1 -1 -1 -1 -1 -1 -1 -1 -1 -1 -1 -1 -1 -1 -1 -1 -1 -1 -1 -1 -1 -1 -1 -1 -1 -1 -1 -1
-1 -1 -1 -1 -1 -1 -1 -1 -1 -1 -1 -1 -1 -1 -1 -1 -1 -1 -1 -1 -1 -1 -1 -1 -1 -1 -1 -1 -1 -1 -1 -1 -1 -1 -1 -1 -1 -1 -1 -1
-1 -1 -1 -1 -1 -1 -1 -1 -1 -1 -1 -1 -1 -1 -1 -1 -1 -1 -1 -1 -1 -1 -1 -1 -1 -1 -1 -1 -1 -1 -1 -1 -1 -1 -1 -1 -1 -1 -1 -1
-1 -1 -1 -1 -1 -1 -1 -1 -1 -1 -1 -1 -1 -1 -1 -1 -1 -1 -1 -1 -1 -1 -1 -1 -1 -1 -1 -1 -1 -1 -1 -1 -1 -1 -1 -1 -1 -1 -1 -1
-1 -1 -1 -1 -1 -1 -1 -1 -1 -1 -1 -1 -1 -1 -1 -1 -1 -1 -1 -1 -1 -1 -1 -1 -1 -1 -1 -1 -1 -1 100 101 -1 -1 -1 57 58 -1 -1 -1
-1 -1 100 101 -1 -1 -1 -1 -1 -1 -1 -1 -1 -1 97 98 99 -1 -1 -1 -1 -1 57 58 -1 -1 -1 112 112 72 118 119 120 113 114 75 76 153 114 112
72 153 118 119 120 72 73 113 112 113 114 112 114 73 115 116 117 113 72 73 114 112 75 76 114 153 114 166 166 166 166 166 166 166 166 166 166 166 166 166
166 166 166 166 166 166 166 166 166 166 166 166 166 166 166 166 166 166 166 166 166 166 166 166 166 166 166 165 165 165 165 165 165 165 165 165 165 165 165 165
162 162 165 162 162 163 164 163 165 165 163 164 163 162 164 164 163 162 162 164 165 164 163 165 165 165 162 162 163 162 162 165 165 164 164 163 162 163 164 162
162 168 167 169 163 163 163 165 165 165 165 165 164 163 162 164 164 163 163 163 165 163 164 163 164 164 186 188 165 164 165 168 188 167 167 167 185 163 165 162
187 164 165 164 162 165 162 188 170 164 162 164 162 163 162 163 165 162 164 162 163 164 186 167 165 165 163 162 165 164 165 169 185 169 167 186 186 165 164 187
162 167 163 168 162 162 187 185 187 186 164 163 164 165 165 168 187 162 188 186 168 187 164 186 170 167 187 187 164 162 169 165 163 164 163 169 163 164 165 165
168 163 164 168 186 162 167 169 170 188 169 165 167 162 187 187 186 186 187 187 170 186 165 188 170 162 169 164 165 169 163 187 167 170 162 185 188 185 188 186
162 188 187 164 170 169 185 167 168 186 188 185 167 170 186 163 185 168 163 169 163 170 185 167 188 162 165 165 187 188 187 188 163 185 188 165 169 169 167 165
162 187 188 187 186 168 162 165 169 168 187 164 164 168 187 187 188 168 188 167 168 168 169 186 169 168 167 187 168 167 170 168 169 187 170 170 186 187 170 164
169 186 186 188 185 188 185 188 185 167 186 188 187 185 185 167 169 185 185 188 168 168 168 187 186 188 168 188 168 169 170 170 187 185 167 167 185 185 185 186
162 187 188 187 186 168 162 165 169 168 187 164 164 168 187 187 188 168 188 167 168 168 169 186 169 168 167 187 168 167 170 168 169 187 170 170 186 187 170 164
169 186 186 188 185 188 185 188 185 167 186 188 187 185 185 167 169 185 185 188 168 168 168 187 186 188 168 188 168 169 170 170 187 185 167 167 185 185 185 186
